1 13 31
###############################
#          *********          #
#   **#                 #**   #
#   *    #  *******  #    *   #
#   #  1 *  **# #**  *    #   #
#     #*##  *# * #*  #*##     #
#           * *x* *           #
#     #*##  *# * #*  #*##     #
#   #    *  **# #**  * 2  #   #
#   *    #  *******  #    *   #
#   **#                 #**   #
#          *********          #
###############################
