1 13 31
###############################
#          *********          #
#   **#                 #**   #
#   *2   #           #    *   #
#   #  1 *  **# #**  *    #   #
#**#  #*##  *# * #*  #*##  #**#
#***#       * *x* *       #***#
#**#  #*##  *# * #*  #*##  #**#
#   #    *  **# #**  * 2  #   #
#   *    #           #   1*   #
#   **#                 #**   #
#          *********          #
###############################
