1 15 25
#########################
#                       #
# #####           ##### #
# #                   # #
# #       ** **       # #
# #      *  *  *      # #
# #     *       *     # #
#        *     *        #
#         *   *         #
# #        * *        # #
# #         *         # #
# #                   # #
# #####           ##### #
#                       #
#########################