1 13 31
###############################
#         ***********         #
#   **#   *         *   #**   #
#   *2   #*         *#    *   #
#   #    *# **# #** #*    #   #
#**#  #*##  *# * #*  #*##  #**#
#***#       * *x* *       #***#
#**#  #*##  *# * #*  #*##  #**#
#   #    *# **# #** #* 2  #   #
#   *    #*         *#   1*   #
#   **#   *         *   #**   #
#         ***********         #
###############################
